NO textures/cobblestone_01.xpm
SO textures/cobblestone_02.xpm
WE textures/mossy_cobblestone1.xpm
EA textures/cobblestone.xpm

F 44,44,44
C 26,43,60


11111111111111111111111111111111111111111111111111
10000001000000010000000010000000000000100000100001
10111101011111011111101110111111111110101110101001
10000101000001000000001000100000000100001000100001
11110101111011111101111011111101110111111010111001
10000100001000000101000000000101000000001010100001
10111111101011110111101111111101011111111110111111
10000000101000100000100000000001000000000000100001
10111110111111101110111111101111111011111111101001
10000100000000100000000000100000001000100000001001
11111111111110111110111110101110101110101111111101
10000000000100000100000100000000100000100000000001
10111111101111111111101111111111101110111111111101
10000100001000000000001000100000100000100000000001
11110101111111111111101110111110111110111111101111
10000101000000000000100000000000100000100000100001
10111101111111111110111111111110111110111011101001
10000100000000000100000000000010000000001000100001
11110111111110111111111110111111111110101110101111
10000000000100000000000010000100000000100000100001
10111111101111111111111110111110111111111111101111
10000000100000000000100000000010000000000000100001
11111110111111111110101111111110111110111111101111
10000000000000000000100000000010000100000000100001
11110111111111111110111111111111101111111110111111
10000100000000100000000000100000000000100000100001
10111101111110111110111111101111111111101111111101
10000101000100000100000100000000000000001000000001
10110101011111101111101111111110111111101111101101
10000100000000001000000000000010000000100000000001
11111111111111101111111110111110111110111110111101
10000000000000100000000100000000100000100000100001
10111111111110101111111111101111101110111110111101
10000000100000000000000000100000001000000000100001
10111111111111101111111110111110101111111110111111
10000000000000001000000000000100000000100000100001
11111111111110101110111111111110111111111111111101
10000000000100000000000000000010000000000000000001
10111110101111111111111111111110111110111111101111
10000100101000000100000000000000000000000000100001
11110111111111111110111111111111111110111111111111
10000100000000000000000000000000100000000000000001
10000100000000000000100000000000100000000N00000001
10111101111110111110111111101111101110111111111101
10000101000100000100000100000000000000001000000001
10110101011111101111101111111110111111101111101101
10000100000000001000000000000010000000100000000001
11111111111111101111111110111110111110111110111101
10000000000000100000000100000000100000100000100001
10111111111110101111111111101111101110111110111101
10000000100000000000000000100000001000000000100001
10111111111111101111111110111110101111111110111111
10000000000000001000000000000100000000100000100001
11111111111110101110111111111110111111111111111101
10000000000100000000000000000010000000000000000001
11111111111111111111111111111111111111111111111111
